111111111111
1C00P01000V1
100110000001
11001C0000E1
1000V010C001
111111111111