111111111111111111
1V0CC000C00C000001
11V1110V01V0V100C1
10CP000C1C00C000V1
1101010V0100000111
110V0V01C0CV1V0VC1
1VC001000101100C01
1C00C10VC10V100101
10C0C0C01C00000VE1
111111111111111111