111111111111111111111111111111111111111111111111111111111111111111
1PC0E0000000000000000000000000000000000000000000000000000000000001
100000000000000000000000000000000000000000000V00000000000000000001
1000000V000000000000000000000000000000000000000000V000000000000001
100000000000000000000000000000000000000000000000000000000000000001
100000000000000000000000000000000000000000000000000000000000000001
100000000000000000000000000000000000000000000000000000000000000001
111111111111111111111111111111111111111111111111111111111111111111