1111111
1000P01
1001101
1ECV1C1
1111111