1111111
1E00P01
1011101
110V1C1
10C0001
1111111