111111111111111111
1V0CC000C00C000001
11V1110V01V0V100C1
1VCP000C1C00C00VV1
1101010V010V0V0111
110V0V01C0CV1V0VC1
1VC001000101100C01
1C0VC10VC10V1V0101
10C0C0C01C00010VE1
111111111111111111