1111111
1000P01
1C11101
1EVC1C1
1111111