11111111111
10000100001
1P00000C001
10000000001
100E0000C01
11111111111