1111111111
1E00000001
10C0P00001
1000000001
1111111111