1111111111111111111111
1000100000000000000001
1000000000000000000001
10C000C000000000000001
100000000000000E00C001
1000000000000C00000001
10000000000000000000P1
1111111111111111111111