11111111111
1E010001001
100101010P1
11010101001
10000100C01
11111111111