1111111111
10E0000001
10000P0001
10C000C001
1111111111