11111111111
1E010001001
10010100001
11010001001
10000CP0001
11111111111