1111111111
1000000001
10C0P00001
10000000E1
1111111111