11111111111
1E01C001001
10C10100001
11010001001
10000CP00C1
11111111111