1111111111111
1001C00000C01
10P0001011111
100000101C101
1000101001001
10C010E100001
1000101000001
1111111111111