1111111111111
1001C00000C01
100000101V111
10V0E0100C101
1000101001001
101010010V001
101P1010000V1
1111111111111