1111111111111
1001C00000C01
1000001011111
1000E0100C101
1000101001001
1010100100001
101P101000001
1111111111111