111111111111111111111111
10P0100000100000100C0001
100000000010000000000001
10C000C00000000010000001
100000000010000010000001
100E0010001000001000C001
111111111111111111111111