1111111111111
1001C00001C01
10P0001001111
100000100C001
1000100000001
10C010E000001
1000100000001
1111111111111