1111111111111
1001C00000001
10C000101V101
10V0E01000101
1000101001001
101000010V001
101P1010000V1
1111111111111